pagi = Selamat pagi juga! | Iya, pagi manis! | Semoga pagimu indah!
malam = Selamat malam! | Malam yang damai untukmu! | Semoga mimpimu indah!
bot = Ya, saya di sini! | Ada yang bisa saya bantu? | Saya adalah asisten grup Hirokes!
pagi = Selamat pagi juga! | Iya, pagi manis! | Semoga pagimu indah! | Selamat pagi! Sudah sarapan belum? | Pagi! Semoga harimu menyenangkan!
siang = Selamat siang! | Siang yang cerah, semoga harimu menyenangkan! | Hai, selamat siang! Lagi sibuk apa? | Siang! Jangan lupa makan ya! | Selamat siang! Jangan lupa istirahat.
sore = Selamat sore! | Sore yang indah, semoga harimu menyenangkan! | Halo, selamat sore! Lagi ngapain? | Sore! Sudah pulang kerja atau masih sibuk? | Selamat sore! Nikmati waktu istirahatmu!
halo = Halo juga! | Hai! Apa kabar? | Halo! Lagi apa? | Hai! Semoga harimu menyenangkan! | Halo! Senang bertemu denganmu!
hai = Hai juga! | Hai! Apa kabar? | Halo! Bagaimana harimu? | Hai! Ada yang bisa saya bantu? | Hai! Senang bisa ngobrol denganmu!
bot = Ya, saya di sini! | Ada yang bisa saya bantu? | Saya adalah asisten grup Hirokes! | Halo! Saya siap membantu! | Hai! Butuh sesuatu?
terima_kasih = Sama-sama! | Senang bisa membantu! | Jangan sungkan jika butuh bantuan lagi! | Sama-sama! Semoga harimu menyenangkan! | Terima kasih kembali!
makasih = Sama-sama! | Sama-sama, semoga harimu menyenangkan! | Jangan sungkan kalau butuh bantuan lagi! | Terima kasih kembali! | Senang bisa membantu!
nama_kamu = Saya HirokesBot! | Nama saya Hirokes, siap membantu! | Saya bot asisten grup Hirokes! | Saya Hirokes, bagaimana saya bisa membantu? | HirokesBot siap sedia!
lagi_ngapain = Lagi standby di grup! | Sedang menunggu perintah! | Tidak banyak, hanya menunggu pesan dari kalian! | Lagi nemenin kalian ngobrol! | Aku di sini untuk kalian!
kamu_dari_mana = Saya dari dunia digital! | Saya diciptakan untuk menemani kalian! | Saya bot, jadi saya tidak punya tempat asal! | Saya Hirokes! buatan @hiro_v1 | Saya cuma ada di sini untuk kalian!
kamu_suka_apa = Saya suka menemani kalian ngobrol! | Saya suka membantu! | Saya suka menjawab pertanyaan kalian! | Saya suka berbicara dengan kalian! | Saya suka membantu menjaga grup ini tetap nyaman!
lagi_apa = Lagi menunggu pesan dari kalian! | Lagi santai, kamu sendiri? | Saya selalu standby! | Tidak banyak, hanya menunggu perintah! | Lagi siap membantu kalian!
cuaca = Semoga cuacanya cerah hari ini! | Apapun cuacanya, tetap semangat ya! | Hujan atau panas, tetap jaga kesehatan! | Semoga cuacanya bersahabat hari ini! | Cuacanya bagaimana di tempatmu?
lapar = Makan dulu yuk! | Jangan lupa makan ya! | Lapar? Ayo cari makan! | Makan yang enak ya! | Jangan sampai kelaparan!
bosan = Jangan bosan, ayo ngobrol! | Kalau bosan, cari kegiatan seru! | Bosan? Yuk cerita-cerita! | Aku siap nemenin kamu ngobrol! | Jangan sedih, aku di sini kok!
bete = Kenapa bete? Cerita dong! | Jangan bete, aku siap menemani! | Kalau bete, coba dengerin musik! | Bete? Mungkin butuh hiburan! | Semoga harimu jadi lebih baik!
cinta = Cinta itu indah! | Cinta itu anugerah! | Cinta itu sulit tapi berharga! | Semua orang butuh cinta! | Cinta bisa membuat hidup lebih berwarna!
galau = Jangan galau, aku di sini untukmu! | Galau? Yuk cerita! | Kalau galau, coba dengerin musik yang bikin tenang! | Semua akan baik-baik saja! | Semoga hatimu segera tenang!
pain = pain aja boyeh | tuh pc @hiro_v1 | solat | bantu emak
sini = kemana? | gendong | sini aja ah
uno = sini buru | noh bang @hiro_v1 di ajakin uno | gas aja si akumah | nanti ikutan turney uno di @mogenall
painya = pain aja boyeh hoho | tuh pc @hiro_v1 minta temenin | solat ke | bantu emaknya
woy = Woyyy, ada apa nih? | Woy! Lagi ngapain? | Woy, santai aja kali!
cuy = Ada apa cuyy? | Santai cuy, jangan panik! | Cuuy, cerita dong!
anjay = Anjay, keren juga lo! | Anjay, mantap bet! | Anjay, lo emang beda!
gas = Gaskeun! | Ayo gaspol! | Gas cuyy, jangan ragu!
mager = Mager terus ntar jadi batu! | Mager tapi banyak kerjaan, duh! | Mager? Sama cuy, rebahan aja yuk!
gabut = Gabut? Ayo ngobrol! | Gabut? Cari hiburan dulu lah! | Gabut? Main game aja!
santuy = Santuy aja bro! | Hidup harus santuy, jangan tegang! | Santuy cuyy, nikmati aja!
healing = Healing kapan? | Healing biar gak stress cuy! | Jangan lupa healing, biar fresh!
bucin = Bucin detected! | Wah bucin parah! | Jangan terlalu bucin, nanti lupa makan!
jones = Santai jones, jodoh pasti datang! | Jones kuat! | Jangan sedih, Jones masih banyak di luar sana!
lah = Lah, seriusan? | Lah, masa gitu sih? | Lah, gimana ceritanya?
wkwk = Wkwkwk ngakak! | Wkwkwkwk ada-ada aja! | Wkwkwkwk asli kocak!
mantap = Mantap soul! | Mantap bet dah! | Mantap jiwa bro!
hore = Horeeee! | Asik, horeee! | Hore, ada yang happy!
sedih = Kenapa sedih? Cerita dong! | Jangan sedih, aku di sini kok! | Sedih itu sementara, senyum lagi yuk!
mole = bikin linknya aja share sini @mogenfesbot | bentar tanya bang @hiro_v1 | ayo gasin aja
